2 2 2 2 2 2 2 2 2 2 2 2 2 2 2 2 2 2 2 2 2 2 2 2 2 2 2 2 2 2 2 2 2 2 2 2 2 2 2 2 2 2 2 2 2 2 2 2 2 2
2 2 2 2 2 2 2 2 2 2 2 2 2 2 2 2 2 2 2 2 2 2 2 2 2 2 2 2 2 2 2 2 2 2 2 2 2 2 2 2 2 2 2 2 2 2 2 2 2 2
6 6 7 6 6 6 6 6 6 6 6 7 6 6 6 6 6 6 6 4 9 10 10 10 10 10 12 4 6 6 6 6 7 6 6 6 6 6 6 6 6 6 6 6 6 6 4 6 6 6
7 6 6 6 6 6 4 6 6 6 6 6 6 7 6 6 6 6 6 4 8 11 11 11 11 11 13 4 6 6 6 6 6 6 7 6 6 6 6 6 6 6 6 6 6 6 6 6 6 7
6 6 6 6 7 6 6 6 6 6 6 6 6 6 6 6 4 6 6 4 8 11 11 11 11 11 13 4 6 6 6 7 6 6 6 6 6 6 6 6 6 6 4 6 6 6 6 6 6 6
7 6 6 6 6 6 6 6 4 6 6 6 7 6 6 6 6 6 6 4 15 18 11 11 11 17 16 4 7 6 6 6 6 6 6 6 6 6 6 6 6 6 6 6 6 7 6 6 6 6
6 6 6 7 6 6 6 4 1 1 1 1 1 4 6 6 6 6 6 6 6 15 14 14 14 16 6 6 6 6 7 6 6 6 6 6 6 6 6 6 6 6 6 6 6 6 6 6 6 6
6 6 6 6 6 6 6 4 1 3 3 3 1 4 6 6 6 6 6 6 0 0 0 5 0 0 0 4 6 6 6 6 6 0 5 5 5 5 5 5 5 4 6 6 6 6 7 6 6 6
7 6 6 6 6 6 6 4 1 3 3 3 1 4 6 6 6 7 6 6 4 0 0 0 0 0 4 6 6 6 6 6 6 4 5 5 5 5 5 5 5 5 4 6 6 6 6 6 6 7
6 6 6 6 6 6 4 6 1 3 3 3 1 4 6 6 6 6 6 6 4 4 0 0 0 4 6 6 6 6 6 6 6 4 5 5 5 5 5 5 5 5 4 6 6 6 6 6 6 6
7 6 6 6 6 6 6 4 1 3 3 3 1 4 6 6 6 6 6 6 6 4 4 5 4 6 6 6 6 6 6 6 6 4 5 5 5 5 5 5 5 5 4 7 6 6 6 6 6 6
6 6 6 6 6 7 6 4 1 1 0 1 1 4 6 6 6 6 6 6 6 6 4 5 4 6 6 6 6 6 6 6 6 4 5 5 5 5 5 5 5 5 4 6 6 6 6 7 6 6
7 6 6 6 6 6 6 6 4 4 0 4 4 6 6 6 6 6 6 6 6 6 4 5 4 6 6 6 7 6 6 6 6 4 4 5 5 5 5 5 5 4 6 6 6 6 6 6 6 6
4 6 6 6 6 6 6 6 6 4 0 4 6 6 6 6 6 6 6 6 6 6 4 5 4 6 6 6 6 6 6 6 6 6 4 4 4 4 5 5 6 6 6 6 6 6 7 6 6 6
4 6 6 6 6 6 7 6 6 4 0 4 6 6 6 6 6 6 6 6 6 6 4 5 4 6 6 6 6 6 6 6 6 6 6 6 6 6 4 5 4 6 6 6 6 6 6 6 6 6
6 6 6 6 6 6 6 6 6 4 0 4 6 6 6 6 6 6 6 6 6 6 4 5 4 6 6 6 7 6 6 6 6 6 6 6 6 6 4 5 4 6 6 6 6 6 6 6 6 7
4 6 6 7 6 6 6 6 0 0 0 4 6 6 6 6 6 6 6 6 6 6 4 5 4 6 6 6 6 6 6 6 6 6 6 6 6 6 4 5 4 6 6 6 6 6 6 6 6 6
6 6 6 6 6 6 6 6 0 4 4 4 6 6 6 6 6 6 6 6 6 6 4 5 4 6 6 6 6 6 6 6 6 6 6 6 6 6 4 5 4 6 6 6 7 6 6 6 6 6
4 6 6 6 6 6 6 6 0 4 6 6 6 6 6 6 6 6 6 6 6 6 0 5 0 4 6 6 6 6 6 6 6 6 6 6 6 5 5 5 4 6 6 6 6 6 6 6 6 6
4 6 6 6 6 6 6 6 0 4 6 6 6 6 6 6 6 6 6 6 4 0 0 5 0 0 4 6 6 6 6 6 6 6 6 6 4 5 4 4 6 6 6 6 6 6 6 7 6 6
4 4 6 6 6 6 6 6 0 4 6 6 6 6 6 6 6 6 6 4 0 0 0 5 0 0 0 4 6 6 6 6 6 6 6 4 5 5 4 6 6 6 6 6 6 6 6 6 6 6
4 6 6 6 6 6 6 6 0 4 6 6 5 5 5 5 5 5 5 5 5 5 5 5 5 5 5 5 5 5 5 5 5 5 5 5 5 5 6 6 6 7 6 6 6 6 6 6 6 6
6 6 6 6 6 6 6 6 0 4 6 6 0 4 6 6 6 6 6 4 0 0 0 5 0 0 0 4 6 6 6 6 6 6 6 6 4 5 4 6 6 6 6 6 6 6 6 6 6 6
7 6 6 6 6 6 6 6 0 4 6 6 0 4 6 6 6 6 6 4 4 0 0 5 0 0 4 6 6 6 6 6 6 6 6 6 4 5 4 6 6 6 6 6 6 7 6 6 6 6
6 6 6 6 6 6 6 6 0 4 6 6 0 4 6 6 6 6 6 6 4 4 0 5 0 4 6 6 6 6 6 6 6 6 6 6 4 5 4 6 6 6 6 6 6 6 6 6 6 6
6 6 6 6 6 6 6 6 0 4 6 6 0 0 0 4 6 6 6 6 6 4 4 5 4 6 6 6 6 6 6 6 6 6 6 6 4 5 4 6 6 6 6 6 6 6 6 6 6 7
4 6 6 6 6 6 6 6 0 4 6 6 6 4 0 4 6 6 6 6 6 6 4 5 4 6 6 6 6 6 6 6 6 6 6 6 4 5 4 6 6 6 6 6 6 6 6 6 6 6
4 6 6 6 6 6 6 6 0 4 6 6 6 4 0 4 6 6 6 6 6 6 4 5 4 6 6 4 0 4 6 6 6 6 6 4 0 5 4 6 6 6 6 6 6 6 6 6 6 6
7 6 6 6 6 6 6 6 0 4 6 6 6 4 0 4 6 6 6 6 6 6 4 5 4 6 6 6 6 6 0 4 6 6 6 4 4 5 4 6 6 6 6 6 6 6 6 6 6 6
6 6 6 6 6 6 6 6 0 0 0 0 0 0 0 4 6 6 6 6 6 6 4 5 4 6 6 6 6 6 0 4 6 6 6 4 4 5 4 6 6 6 6 6 6 6 6 6 6 6
6 6 6 6 6 6 6 6 0 0 0 0 0 0 0 4 6 6 6 6 6 6 4 5 4 6 6 6 6 6 6 6 6 6 6 4 4 0 4 6 6 6 6 6 6 6 6 6 6 6
7 6 6 6 6 6 6 6 0 0 0 0 0 0 0 4 6 6 6 6 6 6 4 5 4 6 6 6 6 6 6 6 6 6 6 0 0 0 4 6 6 6 6 6 6 6 6 6 6 6
6 6 6 6 6 6 6 6 0 0 0 0 0 0 0 4 6 6 6 6 6 6 4 5 4 6 6 6 6 6 6 6 6 6 6 0 0 0 4 6 6 6 6 6 6 6 6 6 6 7
6 6 6 6 6 6 6 6 0 0 0 0 0 0 0 4 6 6 6 6 6 6 4 5 4 6 6 6 6 6 6 6 6 6 6 0 0 0 4 6 6 6 6 6 6 6 6 6 6 6
6 6 6 6 6 6 6 6 0 0 0 0 0 0 0 4 6 6 6 6 6 6 4 5 4 6 6 6 6 6 6 6 6 6 6 0 0 0 4 6 6 6 6 6 6 6 6 6 6 6
4 6 6 6 6 6 6 7 6 6 6 6 6 6 6 6 6 6 6 6 6 6 4 5 4 6 6 6 6 6 6 6 6 6 6 0 0 0 4 6 6 6 6 6 6 6 6 6 6 6
6 6 6 6 6 6 6 6 6 6 6 6 6 6 6 6 6 6 6 0 0 0 0 0 0 0 0 4 6 6 6 6 6 6 0 0 0 0 0 4 6 6 6 6 6 6 6 6 6 6
7 6 6 6 6 6 6 6 6 6 6 6 6 6 6 6 6 6 0 0 0 0 0 0 0 0 0 0 4 6 0 4 4 0 0 0 0 0 0 4 6 6 6 6 6 6 6 6 6 6
6 6 6 6 6 6 6 6 6 6 6 6 6 6 6 6 6 6 0 0 0 0 0 0 0 0 0 0 4 6 6 4 0 0 0 0 0 0 0 4 6 6 6 6 6 6 6 6 6 7
6 6 6 6 6 6 6 6 6 6 6 6 6 0 4 6 6 6 0 0 0 0 0 0 0 0 0 0 0 4 6 6 0 0 0 0 0 4 0 4 6 6 6 6 6 6 6 6 6 6
6 6 6 6 6 6 6 6 6 6 6 6 6 6 6 6 6 6 0 0 0 0 0 0 0 0 0 0 0 0 0 0 0 0 4 0 0 0 0 4 6 6 6 6 6 6 6 6 6 6
4 6 6 6 6 6 6 6 6 6 6 6 6 0 4 6 6 6 4 0 0 0 0 0 0 0 0 4 6 6 4 0 0 0 0 0 0 0 0 4 6 6 6 6 6 6 6 6 6 7
4 6 6 6 6 6 6 6 6 6 6 6 6 6 6 6 6 6 6 4 0 0 0 0 0 0 4 6 6 6 6 0 0 4 0 0 4 0 0 4 6 6 6 6 6 6 6 6 6 6
6 6 6 6 6 6 6 6 6 6 6 6 6 6 6 6 6 6 6 6 6 6 6 6 6 6 6 6 6 6 6 4 0 0 0 0 0 0 4 6 6 6 6 6 6 6 6 6 6 6
6 7 6 6 6 6 6 6 6 6 6 6 6 6 6 6 6 6 6 6 6 6 6 6 6 6 6 6 6 6 6 6 6 6 6 6 6 6 6 6 6 6 6 6 6 6 6 6 6 6
6 6 6 6 6 6 6 6 7 6 6 6 6 6 6 6 6 6 6 6 6 6 6 6 6 6 6 6 6 6 6 6 6 6 6 6 6 6 6 6 6 6 6 6 6 6 6 6 6 6
7 6 6 6 6 6 6 6 6 6 6 6 6 6 6 6 6 6 6 6 6 6 6 6 6 6 6 6 6 6 6 6 6 6 6 6 6 6 6 6 6 6 6 6 6 6 6 6 6 6
6 6 6 6 6 6 6 6 6 6 6 6 6 6 6 6 6 6 6 6 6 6 6 6 6 6 6 6 6 6 6 6 6 6 6 6 6 6 6 6 6 6 6 6 6 6 6 6 6 6
6 6 6 6 6 6 6 6 6 6 6 6 6 6 6 6 6 6 6 6 6 6 6 6 6 6 6 6 6 6 6 6 6 6 6 6 6 6 6 6 6 6 6 6 6 6 6 6 6 6
6 6 6 6 6 6 6 6 6 6 6 6 6 6 6 6 6 6 6 6 6 6 6 6 6 6 6 6 6 6 6 6 6 6 6 6 6 6 6 6 6 6 6 6 6 6 6 6 6 6
