1 1 1 1 1 1 1 1 1 1 1 1 1 1 1 1 1 1 1 1 1 1 1 1 1 1 1 1 1 1 1 1 1 1 1 1 1 1 1 1 1 1 1 1 1 1 1 1 1 1
1 0 0 0 0 0 6 0 0 0 0 0 0 0 0 0 0 0 0 0 0 0 0 0 0 5 0 0 6 0 0 0 6 0 0 0 0 0 0 0 6 0 0 0 0 0 0 0 0 1
1 0 6 0 0 0 0 0 0 6 0 0 0 0 6 0 6 0 6 0 0 0 0 0 0 5 0 0 0 0 0 0 0 0 0 0 0 6 0 0 0 0 0 0 0 0 0 0 6 1
1 0 6 0 0 0 0 6 6 0 0 0 0 0 0 6 0 0 0 6 0 0 0 0 0 5 0 0 6 0 0 0 0 6 0 0 0 0 0 0 0 0 0 0 0 0 0 0 6 1
1 0 0 0 0 0 0 0 0 0 0 0 0 0 0 0 0 0 0 0 0 0 0 0 0 5 0 0 0 0 0 0 0 0 0 0 0 0 0 6 6 0 0 0 0 0 6 0 6 1
1 0 0 0 0 0 0 0 0 0 0 6 6 6 0 0 0 0 6 0 0 0 0 0 0 5 0 0 0 0 0 0 0 0 0 0 6 0 0 6 0 0 0 0 0 0 0 0 0 1
1 0 0 0 0 0 0 0 0 0 0 0 6 0 0 0 0 0 0 0 6 0 6 0 0 5 0 0 0 0 0 0 0 0 0 0 0 0 0 0 0 0 0 0 0 0 0 0 0 1
1 0 0 0 0 6 0 6 0 0 0 0 0 0 6 0 0 0 0 0 0 0 0 0 0 5 6 0 0 0 0 0 0 0 0 0 0 0 0 0 0 0 0 0 0 0 0 0 0 1
1 0 6 0 0 0 6 0 0 6 0 0 0 0 0 0 6 0 0 0 0 0 0 0 0 5 0 0 0 6 6 0 0 6 0 6 0 0 0 0 0 0 0 0 0 0 0 0 0 1
1 6 6 0 0 0 0 0 0 0 0 0 0 0 6 6 6 0 0 0 0 0 0 0 0 5 0 0 0 0 0 0 0 0 0 0 0 0 6 0 0 6 0 0 0 0 6 0 0 1
1 0 6 0 6 0 0 0 0 0 0 0 0 0 0 0 0 0 0 0 0 0 0 0 6 5 0 0 0 0 6 0 0 0 0 0 0 0 0 0 0 0 0 0 0 0 0 0 0 1
1 0 0 6 0 0 0 0 0 0 0 0 6 0 0 0 0 0 6 0 0 0 0 0 0 5 0 0 0 0 0 0 0 0 0 6 0 0 0 0 0 0 0 0 0 0 0 0 0 1
1 0 0 0 0 0 0 0 6 0 0 0 0 6 0 6 0 6 0 0 0 6 6 0 6 5 0 0 0 0 6 0 0 0 6 0 0 0 6 0 0 0 0 0 0 0 0 0 0 1
1 0 0 0 0 0 6 0 6 0 0 0 0 0 0 0 0 0 0 6 0 0 0 0 0 5 0 0 0 0 0 0 0 6 0 0 0 0 0 0 0 6 0 0 0 0 0 0 0 1
1 0 0 0 0 6 0 0 0 0 0 0 0 0 0 6 0 6 0 0 0 0 0 0 6 5 0 0 0 0 0 0 0 0 6 6 0 6 0 6 0 0 0 0 6 0 0 0 0 1
1 0 0 0 0 0 0 0 0 0 0 0 0 6 0 6 0 0 0 0 0 0 0 0 0 5 5 6 0 0 0 0 0 0 0 3 0 0 0 0 0 0 0 0 0 0 0 0 0 1
1 0 0 0 6 0 0 0 6 0 0 0 6 0 6 0 3 0 3 0 0 0 0 0 3 5 3 0 0 0 0 0 0 6 0 0 0 6 0 0 0 0 0 0 0 0 0 0 6 1
1 0 0 0 6 0 0 0 0 0 6 0 0 0 0 0 6 3 0 0 0 6 0 0 6 5 6 3 0 6 6 0 3 0 0 3 0 6 0 0 0 0 0 0 0 6 0 6 0 1
1 0 0 0 0 0 6 0 0 0 0 0 0 0 0 0 0 0 2 2 2 2 2 2 2 5 2 2 2 2 2 2 2 3 0 0 0 0 0 0 0 0 0 0 6 0 0 0 0 1
1 0 6 0 0 0 0 0 0 0 0 6 0 0 0 6 6 0 2 2 2 2 2 2 2 5 2 2 2 2 2 2 2 0 0 0 0 0 0 0 0 0 0 0 0 0 0 0 0 1
1 0 0 0 0 0 0 0 0 0 0 0 0 0 0 0 0 0 2 2 2 2 2 2 2 5 2 2 2 2 2 2 2 0 3 0 6 0 0 0 6 0 0 0 0 0 0 0 0 1
1 0 0 0 0 0 0 0 0 0 0 0 0 6 0 0 0 3 2 2 2 2 2 2 2 5 2 2 2 2 2 2 2 6 0 0 0 0 0 0 0 0 0 6 0 0 0 0 6 1
1 0 0 0 0 0 0 0 6 0 0 0 6 0 6 0 0 6 2 2 2 2 2 2 2 5 2 2 2 2 2 2 2 0 0 3 0 6 6 0 0 0 0 0 0 0 0 0 0 1
1 0 6 0 0 0 0 0 0 0 0 0 0 0 0 0 0 0 2 2 2 2 2 2 2 5 2 2 2 2 2 2 2 0 0 6 0 0 0 0 6 0 0 0 0 0 6 0 0 1
1 0 0 0 0 0 0 0 0 0 0 0 0 0 0 0 0 0 2 2 2 2 2 2 2 5 2 2 2 2 2 2 2 0 3 3 0 0 0 0 0 0 6 0 0 0 0 0 0 1
1 0 0 0 6 0 0 0 6 0 0 0 0 0 0 3 0 0 2 2 2 2 2 2 2 5 2 2 2 2 2 2 2 3 0 0 0 0 0 0 0 0 0 0 0 0 0 0 0 1
1 6 0 0 0 0 0 0 6 0 6 0 6 0 0 0 0 0 2 2 2 2 2 2 2 5 2 2 2 2 2 2 2 0 3 3 0 0 0 0 6 0 0 0 0 0 0 0 0 1
1 0 0 0 0 0 0 0 6 0 6 0 0 0 0 3 0 0 2 2 2 2 2 2 2 5 2 2 2 2 2 2 2 0 3 3 0 6 0 0 0 0 0 0 0 0 0 0 0 1
1 6 0 6 6 0 6 0 0 0 0 0 0 0 0 0 0 0 2 2 2 2 2 2 2 5 2 2 2 2 2 2 2 0 0 0 0 0 0 6 0 0 0 0 6 0 0 0 0 1
1 0 0 0 0 0 0 0 6 0 0 6 6 0 0 0 3 6 2 2 2 2 2 2 2 5 2 2 2 2 2 2 2 0 0 6 0 0 0 0 0 0 0 6 0 0 0 0 0 1
1 0 0 0 0 0 0 0 0 0 0 0 0 0 6 0 3 3 2 2 2 2 2 2 2 5 2 2 2 2 2 2 2 0 0 0 6 0 0 6 0 0 0 6 0 0 6 0 0 1
1 6 6 0 0 6 6 0 0 0 0 0 0 0 0 3 6 6 2 2 2 2 2 2 2 5 2 2 2 2 2 2 2 0 0 0 0 6 0 0 0 0 0 0 0 0 0 0 0 1
1 0 0 0 0 0 0 0 0 0 0 0 0 0 0 6 6 3 2 2 2 2 2 2 2 5 5 2 2 2 2 2 2 0 3 0 6 0 6 0 0 0 0 0 0 0 0 0 0 1
1 0 0 0 0 0 0 0 6 0 0 0 0 0 0 0 3 3 3 0 0 3 3 3 3 5 3 0 6 0 6 0 3 0 0 6 0 0 0 6 0 0 0 0 0 0 0 0 0 1
1 0 0 0 0 0 0 0 6 0 0 0 0 0 0 0 3 0 0 0 3 0 0 0 0 5 0 0 0 3 0 0 0 0 0 0 0 0 0 0 0 0 0 6 0 0 0 0 0 1
1 0 0 4 4 4 4 4 4 4 4 4 4 4 4 0 0 0 6 3 0 6 3 0 3 5 0 6 0 0 0 0 3 0 0 0 0 0 6 6 6 0 6 0 0 0 0 0 0 1
1 0 0 4 4 4 4 4 4 4 4 4 4 4 4 0 6 0 0 0 0 0 0 0 0 5 0 0 0 0 0 0 0 0 0 0 0 0 0 0 0 0 0 0 6 0 0 0 0 1
1 0 0 4 4 4 4 4 4 4 4 4 4 4 4 0 0 0 0 0 0 0 6 0 0 5 0 0 0 6 0 0 0 0 0 0 0 0 0 0 0 0 0 0 0 0 0 6 0 1
1 0 0 4 4 4 4 4 4 4 4 4 4 4 4 0 6 0 0 0 6 0 0 6 0 5 5 0 0 0 0 6 0 0 0 6 0 6 0 0 0 0 0 0 6 0 0 0 0 1
1 0 0 4 4 4 4 4 4 4 4 4 4 4 4 0 0 6 0 0 0 0 0 0 0 5 0 0 0 6 0 0 0 0 0 0 0 0 0 0 0 0 0 0 6 6 0 0 0 1
1 0 0 4 4 4 4 4 4 4 4 4 4 4 4 0 0 0 0 0 6 6 0 0 0 5 5 0 0 0 0 0 6 0 0 0 0 0 6 0 0 0 6 0 0 0 0 6 0 1
1 0 0 4 4 4 4 4 4 4 4 4 4 4 4 0 0 0 0 0 0 0 0 0 6 5 0 0 0 0 0 0 0 0 0 0 0 0 0 0 0 0 0 0 0 0 0 0 0 1
1 0 0 4 4 4 4 4 4 4 4 4 4 4 4 0 0 0 6 0 0 0 0 0 6 5 5 0 6 0 0 0 0 6 0 0 6 0 6 0 0 0 0 6 0 0 0 6 0 1
1 0 0 4 4 4 4 4 4 4 4 4 4 4 4 0 0 0 0 6 0 0 0 0 0 5 0 0 0 0 0 0 0 0 0 0 0 0 0 0 6 0 0 0 0 0 6 6 0 1
1 0 0 4 4 4 4 4 4 4 4 4 4 4 4 0 0 6 0 0 0 0 0 0 0 5 0 0 0 0 0 0 6 0 0 0 0 0 0 0 0 0 0 0 0 0 6 0 0 1
1 6 0 4 4 4 4 4 4 4 4 4 4 4 4 0 0 0 0 0 0 0 0 6 0 5 0 0 6 0 0 0 0 6 0 0 0 0 0 6 0 0 6 0 0 0 0 0 0 1
1 0 0 4 4 4 4 4 4 4 4 4 4 4 4 0 0 0 0 0 0 0 0 0 0 5 5 0 6 0 0 0 0 0 0 0 0 0 0 6 0 0 0 0 0 0 0 0 0 1
1 6 0 4 4 4 4 4 4 4 4 4 4 4 4 0 0 0 0 0 0 0 0 0 0 5 0 0 6 6 0 0 0 0 0 0 0 0 0 0 0 0 0 0 0 0 0 0 0 1
1 0 0 0 0 6 0 0 0 0 0 6 0 0 0 0 0 0 0 0 0 0 0 0 0 5 5 0 0 0 6 0 0 0 0 0 0 0 0 0 0 0 0 0 0 0 0 0 0 1
1 1 1 1 1 1 1 1 1 1 1 1 1 1 1 1 1 1 1 1 1 1 1 1 1 1 1 1 1 1 1 1 1 1 1 1 1 1 1 1 1 1 1 1 1 1 1 1 1 1