5 5 5 5 5 5 5 5 5 5 5 5 5 5 5 5 5 5 5 5 5 5 5 5 5 5 5 5 5 5 5 5 5 5 5 5 5 5 5 5 5 5 5 5 5 5 5 5 5 5
40 6 6 6 6 6 6 6 6 6 6 6 6 6 6 6 6 6 6 6 6 6 6 6 6 6 6 6 6 6 6 6 6 6 6 6 6 6 6 6 6 6 6 6 6 6 6 6 6 6
6 6 6 6 6 6 40 6 6 6 6 6 6 6 40 6 6 6 6 40 6 6 6 6 6 6 6 6 6 6 6 6 6 6 6 6 6 6 6 6 6 6 6 6 6 6 6 6 6 6
6 40 6 6 6 6 6 6 6 6 6 6 6 6 6 6 6 6 6 6 6 40 6 6 6 6 6 6 6 40 6 6 6 6 6 6 6 6 6 6 6 6 6 40 6 6 6 6 6 6
6 6 6 6 6 6 6 6 6 6 6 40 6 6 6 6 6 6 6 6 6 6 6 6 6 6 6 6 6 6 6 6 6 6 6 40 6 6 6 6 6 6 6 6 6 6 6 6 40 6
6 6 6 6 40 6 6 6 6 6 6 6 6 6 6 6 6 6 6 6 6 6 6 6 6 6 6 6 6 6 6 6 6 6 6 6 6 6 6 6 6 6 6 6 6 6 6 6 6 6
6 6 6 6 6 6 12 9 9 9 9 9 9 9 9 9 13 6 12 9 9 9 9 9 9 9 9 9 9 13 6 12 9 9 9 9 9 9 9 9 9 9 13 6 6 6 6 6 6 6
6 40 6 6 6 6 8 30 30 28 28 28 28 28 0 0 10 9 11 0 0 0 0 0 0 0 0 0 0 10 9 11 0 0 34 39 39 39 39 39 39 35 3 6 6 6 6 6 6 6
6 6 6 6 6 6 8 30 30 28 27 27 27 28 0 30 0 1 0 0 2 30 4 5 5 5 7 30 2 0 0 0 30 0 37 31 31 31 31 31 31 36 3 6 40 6 6 6 6 6
6 6 6 6 6 6 8 30 30 28 27 27 27 28 0 1 30 1 1 1 2 1 3 6 6 6 8 30 2 0 0 0 30 0 37 31 31 31 31 31 31 36 3 6 6 6 6 40 6 6
6 6 40 6 6 6 8 30 30 28 27 27 27 28 0 1 1 30 1 1 2 30 3 6 6 6 8 30 2 0 30 0 0 0 37 31 31 31 31 31 31 36 3 6 6 6 6 6 6 6
6 6 6 6 6 6 8 30 30 28 27 27 27 28 0 0 1 1 0 0 2 30 10 9 9 9 11 1 2 0 0 0 0 0 32 38 38 38 31 38 38 33 3 6 6 6 6 6 6 6
6 6 6 6 6 6 8 30 30 28 28 27 28 28 2 0 30 30 0 0 2 30 30 30 17 30 30 30 2 0 30 0 0 0 0 0 0 2 18 2 0 0 3 40 6 6 6 6 6 40
6 6 6 6 6 6 8 30 30 30 30 30 2 2 2 0 30 30 0 0 2 2 2 2 18 2 2 2 0 0 0 0 0 0 0 0 0 2 18 2 0 15 42 6 6 6 6 6 6 6
6 40 6 40 6 6 8 30 30 30 2 30 2 2 0 1 1 30 30 0 0 0 0 2 18 2 0 0 0 0 0 0 0 0 0 0 0 2 18 2 0 3 6 6 6 6 6 6 6 6
6 6 6 6 6 6 41 14 16 2 2 30 2 2 1 30 0 1 1 1 1 0 0 2 18 2 0 0 30 30 0 0 30 0 0 0 0 2 18 2 0 3 6 6 6 6 6 6 6 6
6 6 6 6 6 6 6 12 11 30 30 30 2 1 1 1 30 30 30 30 30 0 0 2 18 2 0 30 30 0 0 0 0 0 0 2 2 2 18 2 30 3 6 6 6 6 6 6 6 6
40 6 6 6 6 6 6 8 2 30 2 2 2 1 0 0 0 0 1 1 30 0 0 2 18 2 0 30 0 0 30 30 0 30 0 2 26 21 25 2 0 3 6 6 6 6 6 40 6 6
6 6 6 6 40 6 6 8 2 30 2 2 2 2 2 2 0 30 30 30 0 0 0 2 18 2 0 0 30 0 0 0 0 0 0 2 18 2 2 0 0 3 6 6 6 6 6 6 6 6
6 6 6 6 6 6 6 8 2 30 2 2 2 30 30 2 2 2 2 2 2 2 2 30 18 30 2 2 2 2 2 2 2 2 2 2 18 2 0 0 15 42 6 6 6 40 6 6 6 6
6 6 6 6 6 6 6 8 2 30 30 2 2 30 20 21 21 21 21 21 21 21 21 21 23 21 21 21 21 21 21 21 21 21 21 21 24 2 0 30 3 6 6 6 6 6 6 6 6 6
6 6 6 6 6 6 6 8 2 2 30 2 2 30 30 2 2 2 2 2 2 2 2 30 18 30 2 2 2 2 2 2 2 2 2 2 18 2 30 0 3 6 6 6 6 6 6 6 6 6
6 6 6 6 6 6 6 8 2 2 30 2 2 30 2 2 2 0 0 0 0 0 0 2 18 2 0 0 0 0 0 0 0 0 0 2 18 2 30 0 3 6 6 6 6 6 40 6 6 6
6 6 6 40 6 6 6 8 2 2 30 2 2 30 2 2 2 0 0 0 1 0 0 2 18 2 0 1 0 1 0 30 0 0 0 2 18 2 30 30 3 6 6 40 6 6 6 6 6 6
6 6 6 6 6 6 6 8 2 30 30 2 2 30 30 30 2 0 0 1 1 0 0 2 18 2 0 30 30 30 0 0 0 30 0 2 18 2 0 30 3 6 6 6 6 6 6 6 6 6
6 6 6 6 6 6 6 8 2 30 2 2 2 2 2 30 2 0 30 30 0 0 0 2 18 2 30 0 1 0 1 1 1 0 0 2 18 2 0 0 3 6 6 6 6 6 6 6 6 6
6 6 6 6 6 6 6 8 2 30 2 2 2 2 2 30 2 0 1 30 30 0 0 2 18 2 0 1 1 0 0 1 30 0 0 2 18 2 30 0 3 6 6 6 40 6 6 6 6 6
6 6 40 6 6 6 6 8 2 30 30 30 30 30 30 30 2 2 1 30 1 0 0 2 18 2 0 1 1 1 0 30 30 0 0 2 18 2 0 0 3 6 6 6 6 6 6 6 6 6
6 6 6 6 6 6 6 8 2 30 30 30 30 30 30 30 2 2 1 1 1 0 0 2 18 2 0 30 1 0 0 1 0 0 0 2 19 2 0 15 42 6 6 6 6 6 6 6 40 6
6 6 6 6 6 6 6 8 2 2 30 30 30 30 2 30 2 2 1 1 30 30 0 2 18 2 0 30 0 0 0 30 30 0 0 2 30 2 30 3 6 6 6 6 6 6 6 6 6 6
6 6 6 6 6 6 6 8 2 2 30 30 30 30 30 30 2 0 0 1 30 30 30 2 18 2 0 30 1 0 0 1 0 0 0 2 30 2 2 3 6 6 6 6 6 6 6 6 6 6
6 6 6 6 40 6 6 41 16 2 30 2 30 30 30 30 2 0 0 30 0 1 0 2 18 2 0 1 1 0 0 0 0 0 0 2 30 30 2 3 6 6 6 6 6 6 6 6 6 6
6 6 6 6 6 6 6 6 8 2 30 30 30 30 2 30 2 0 30 30 0 1 0 2 18 2 0 0 30 1 1 1 0 0 0 2 30 30 30 3 6 6 6 6 6 6 40 6 6 6
6 6 6 6 6 6 6 12 11 2 30 30 30 30 30 30 2 0 1 30 0 1 0 2 18 2 0 0 30 0 1 0 1 1 30 2 30 30 30 10 13 6 6 6 6 6 6 6 6 6
6 6 6 6 6 6 6 8 0 2 2 2 2 2 2 2 2 0 1 0 0 1 0 2 18 2 0 0 30 0 1 1 30 1 30 2 30 30 30 30 3 6 6 6 6 6 6 6 6 6
40 6 6 6 6 6 6 8 0 30 0 1 0 0 0 0 0 30 0 0 0 0 2 2 19 2 2 2 0 0 1 1 1 2 2 2 30 30 30 30 3 6 6 6 6 6 6 6 6 6
6 6 6 40 6 6 6 8 0 0 1 1 0 1 1 0 0 0 0 2 2 2 2 30 30 30 30 30 2 0 30 0 2 2 30 2 30 2 30 2 10 13 6 6 6 6 6 6 6 6
6 6 6 6 6 6 6 8 0 1 30 1 1 30 30 1 0 30 2 2 30 30 30 30 30 30 30 30 2 0 0 0 2 30 2 2 30 30 30 30 30 3 6 6 40 6 6 6 6 6
6 6 6 6 6 6 6 8 30 1 30 1 30 30 0 1 0 0 2 30 2 30 30 30 30 30 2 30 2 2 0 0 2 30 2 30 30 30 30 30 30 10 6 6 6 6 6 6 6 6
6 6 6 6 6 6 6 8 1 30 30 1 1 30 1 30 0 0 2 30 30 30 2 30 30 30 30 30 30 2 2 2 2 2 2 30 30 30 30 30 2 30 3 6 6 6 6 6 6 6
6 6 6 40 6 6 6 8 1 30 1 1 1 1 1 0 0 0 2 30 30 30 30 30 30 30 30 30 30 30 30 30 30 30 30 30 30 30 30 30 30 30 3 6 6 6 6 40 6 6
6 6 6 6 6 6 6 8 0 1 1 30 1 1 30 30 0 15 16 30 30 2 30 30 30 30 30 30 30 15 16 30 30 30 2 2 30 30 30 30 30 30 3 6 6 6 6 6 6 6
6 6 6 6 6 6 6 8 0 0 30 30 0 0 0 0 15 42 41 16 30 30 30 30 30 30 30 30 15 42 8 30 2 30 30 30 30 30 30 30 30 30 3 6 6 6 6 6 6 6
6 6 6 6 6 6 6 41 14 14 14 14 14 14 14 14 42 6 6 41 14 14 14 14 14 14 14 14 42 6 41 16 30 30 30 2 30 30 30 30 15 14 40 6 6 6 6 6 6 6
6 40 6 6 6 40 6 6 6 6 6 6 6 6 6 6 40 6 6 6 6 6 6 6 6 6 6 6 6 40 6 41 14 14 14 14 14 14 14 14 42 6 6 6 6 6 40 6 6 6
6 6 6 6 6 6 6 6 6 6 40 6 6 6 6 6 6 6 6 6 6 6 40 6 6 6 6 6 6 6 6 6 40 6 6 6 6 40 6 6 6 6 6 6 6 6 6 6 6 6
6 6 6 6 6 6 6 6 6 6 6 6 6 6 6 6 6 6 6 6 6 6 6 6 6 6 6 6 6 6 6 6 6 6 6 6 40 6 6 6 6 6 6 40 6 6 6 6 6 6
6 6 6 6 6 6 6 6 6 6 6 40 6 6 6 6 6 6 6 40 6 6 6 6 6 6 6 40 6 6 6 6 6 6 6 6 6 6 6 6 6 6 6 6 6 6 40 6 6 6
6 6 6 6 6 6 6 6 6 6 6 6 6 6 6 6 6 6 6 6 6 6 6 6 6 6 6 6 6 6 6 6 6 6 6 6 6 6 6 6 6 6 6 6 6 6 6 6 6 6
6 40 6 6 6 6 6 6 6 6 6 6 6 6 6 6 6 6 6 6 6 6 6 6 6 6 6 6 6 6 6 6 6 6 6 6 6 6 6 6 6 6 6 6 6 6 6 6 6 6
